{
    "tiles": [
		"#####################",
		"#                   #",
		"#   #o#o#o#o#o#o#   #",
		"#   #o#o#o#o#o#o#   #",
		"#   #E#o#E#E#o#E#   #",
		"#         #         #",
		"#   #############   #",
		"#                   #",
		"#   #o#o#o#o#o#o#   #",
		"#   #o#o#o#o#o#o#   #",
		"#   #o#o#o#o#o#o#   #",
		"#         #         #",
		"#   #############   #",
		"#         #         #",
		"#   #o#o#o#o#o#o#   #",
		"#   #o#o#o#o#o#o#   #",
		"#   #o#o#o#o#o#o#   #",
		"#                   #",
		"#P                  #",
		"#####################"
    ],
    "width": 21,
    "height": 20
}
