{
    "tiles": [
		"###################",
		"#       #ooo   ooo#",
		"#o## ##o#o## # ##o#",
		"#o# o #o#oE# # #Eo#",
		"#o# # #o#o## # ##o#",
		"#   #   #    #    #",
		"#o#####o#o#######o#",
		"#   #   #    #    #",
		"#o# # #o#o## # ##o#",
		"#o# o #o#oE# # #Eo#",
		"#o##o##o#o## # ##o#",
		"#      ooo        #",
		"#######o#o#######o#",
		"# ooooooo     ###o#",
		"# #o#o#o#o#o#ooooo#",
		"# ###o#o#o#o#####o#",
		"#       #        P#",
		"###################"
    ],
    "width": 19,
    "height": 18
}