{
    "tiles": [
        "####################",
        "#                  #",
        "# ################ #",
        "# #  Eooooooooooo# #",
        "# # #o###    #  o# #",
        "#   #ooo#    E  o# #",
        "# #o###o#       o# #",
        "# #ooooo#  #    o# #",
        "# ########o#    o# #",
        "# #oooooooo#    o# #",
        "# #o############o# #",
        "# #Eooooooooooooo# #",
        "# # ############## #",
        "# # ###   #   #  # #",
        "# # #   #   #    # #",
        "# # # ##########   #",
        "# #   oooooooooo # #",
        "# ################ #",
        "#         P        #",
        "####################"
    ],
    "tiles2": [
        "####################",
        "#                  #",
        "# ################ #",
        "# #  Eooooooooooo# #",
        "# # #o###    #  o# #",
        "#   #ooo#    E  o# #",
        "# #o###o#       o# #",
        "# #ooooo#  #    o# #",
        "# ########o#    o# #",
        "# #oooooooo#    o# #",
        "# #o############o# #",
        "# #Eooooooooooooo# #",
        "# # ############## #",
        "# # ###   #   #  # #",
        "# # #   #   #    # #",
        "# # # ##########   #",
        "# #   oooooooooo # #",
        "# ################ #",
        "#         P        #",
        "####################"
    ],
    "width": 20,
    "height": 20
}
